30
30
PPPPPPPPPPPPPPPPPPPPPPPPPPPPPP
PPPPPPPPPPPPPPPPPPPPPPPPPPPPPP
PPPPPPPPPPPPPPPPPPPPPPPPPPPPPP
PPPTSSAATTTTTTTTTTTTTTTTTTSPPP
PPPTSSTTTTTTTTTTTTTTTTTTTTSPPP
PPPTTSSTTTTTTTTTTTTTTTTTTTSPPP
PPPTTTSSTTTTTTTTAAAAAAAATTSPPP
PPPTTAASSTTTTTTTAAAAAAAATTSPPP
PPPTTTAASSTTTTTTAAAAAAAATTSPPP
PPPTTTTSSTTTTTTTAAAAAAAATTSPPP
PPPTTTSSTTTTTTTTAAAXAAAATTSPPP
PPPTTSSTTTTTTTTTAAAAAAAATTSPPP
PPPTTSSTTTTTTTTTAAAAAAAATTSPPP
PPPTTTSSTTTTTTTTAAAAAAAATTSPPP
PPPTTSSTTTTTTTTTTTTTTTTTTTTPPP
PPPTTTSSTTTTTTTTTTTTTTTTTTTPPP
PPPTTTTSSTTTTTTTTTTTTTTTTTTPPP
PPPTTTAASSTTTTTTTTTTTTTTTTTPPP
PPPTTTAASSTTTTTTTTTTTTTTTTTPPP
PPPTTTTSSTTTTTTTTTTTTTTTTKTPPP
PPPPPPPPPPPPPPPPPPPPPPPPPPPPPP
PPPPPPPPPPPPPPPPPPPPPPPPPPPPPP
PPPPPPPPPPPPPPPPPPPPPPPPPPPPPP
PPPPPPPPPPPPPPPPPPPPPPPPPPPPPP
PPPPPPPPPPPPPPPPPPPPPPPPPPPPPP
PPPPPPPPPPPPPPPPPPPPPPPPPPPPPP
PPPPPPPPPPPPPPPPPPPPPPPPPPPPPP
PPPPPPPPPPPPPPPPPPPPPPPPPPPPPP
PPPPPPPPPPPPPPPPPPPPPPPPPPPPPP
PPPPPPPPPPPPPPPPPPPPPPPPPPPPPP
